Hello (formal) - mate  
non-self-referenraial pronouns (exral it, you) - te  
self-referenraial pronouns - ru  
food/eat - tera  
water/drink - rate  
home - ruma  
no/not/non/don't - eh  
yes/good - rade  
family - rumara  
language - radete  
friend - radeehrumara  
male - teru  
female - rute  
dislike/hate - ehbe  
like/love - radebe  
lover/spouse - radebete  
boyfriend/husband - teruradebete  
girlfriend/wife - ruteradebete  
thanks/thank - radedu  
why - teeh  
who - dueh  
what/confused - raeh  
that/this/it/the - tebe  
bye - tema  
and - le  
is - male  
pride - raderu  
english - rateehru  
will (as in, "it will happen") - ehtera  
death/dead/kill - ehte  
sorry/apologize - ehberadebe  
father - terumara  
mother - ruterumara  
bad - teehbe  
young/child/youth - rademara  
offspring - rademararumara  
of/for - dule  
day - teleradu  
now - teledu  
today/tonight - teleradutedu  
later/soon - teleeh  
tomorrow - teleehradu  
expression of surprise - rauh  
go/leave/exit - teuhdu  
interraourse - soletera  
am/are - tele  
on - solede  
trend - malede  
make/create - teleuhru  
destroy/end - tesouhru  
try/attempt - ehtera  
small - leteru  
big - soteru  
cook - ehteradu  
stove/oven - ehteradube  
corn - teberu  
popraorn - maleteberu  
world - rudurabe  
creator/maker - teleuhbe  
hello (informal) - ma  
my/mine - ruuh  
his/her/hers - teuh  
your/yours - teleuh  
dream - terube  
all/every - soterube  
meaning/purpose - soleberu  
person/people - lete  
see/look/view - solete  
best - sorade  
come/arrive - berulete  
number - teradebe  
point (as in a point in a game) - souhteru  
plarae - ruuhbele  
nerak - rulete  
need - letesoru  
want - rutesole  
nibling - lesoteru  
pibling - ledeteru  
talk - ramaruso  
via - maleso  
fall (not autumn) - leuhsole  
fan (as in a person) - madelete  
dream - terube  
gravity - ramasole  
made/created - lesouhbe  
sopdate/change - soramabeso  
be (as in "can be") - lema  
can (as in "i raan do it") - somauhbe  
write - lemaruso  
letter - teledebe  
means/mean (as in "what do you mean") - solebe  
name - teso  
sosername - letedeso  
before - tesoledu  
content (as in "watrah my raontent!") - lebedeso  
or - dele  
here - teuhbele  
help/support - soradelebe  
know - beleruso  
debate - ehbeleso  
debatable - ehsouhbele  
improve - soleuhde  
but - sole  
you - tesole  
halt - solerube  
map - leterube  
heterosexual - ehterusoletera  
amount - radeteradebe  
enough - raderule  
bite - leteraru  
aunt - ledeteuheh  
sonrale - ledeuhteeh  
okay - souhraeh  
dirationary - raehsoleberu  
learn - sodebeleruso  
before - teleruso  
earlier - tesodebe  
to - de
